NO ./path_to_the_north_texture
EA ./path_to_the_east_texture
WE ./path_to_the_west_texture
SO ./path_to_the_south_texture

F 220,100,0
C 225,30,0

1111111111111111111111111
100000000000000000000001
10000000000000000000000N1
100000000000000000000001
1000000000000000000000001
1000000000000000000000001
1111111111111111111111111
